0   0    0    0    0    0    0    0    0    0 0   0
0   0    0    0    0    0    0    0    0    0 0   0
0   0  -10  -20  -30  -40  -40  -30  -20  -10 0   0
0   0  -20  -30  -40  -50  -50  -40  -30  -20 0   0
0   0  -30  -40  -50  -60  -60  -50  -40  -30 0   0
0   0  -40  -50  -60  -70  -70  -60  -50  -40 0   0
0   0  -40  -50  -60  -70  -70  -60  -50  -40 0   0
0   0  -30  -40  -50  -60  -60  -50  -40  -30 0   0
0   0  -20  -30  -40  -50  -50  -40  -30  -20 0   0
0   0  -10  -20  -30  -40  -40  -30  -20  -10 0   0
0   0    0    0    0    0    0    0    0    0 0   0
0   0    0    0    0    0    0    0    0    0 0   0